13 11 14 11 11 11 11 11 11 11 11 14 11 11 11 15
0 0 6 0 0 0 0 0 0 0 0 6 0 0 0 6
3 0 16 11 12 0 13 11 11 11 11 17 11 15 0 6
6 0 6 0 0 0 6 0 0 0 0 6 0 6 0 6
6 0 6 0 13 11 18 0 13 12 0 6 0 9 0 6
6 0 6 0 9 0 6 0 6 0 0 9 0 0 0 6
6 0 6 0 0 0 9 0 6 0 1 0 0 3 0 6
6 0 6 0 10 12 0 0 6 0 0 0 0 6 0 6
6 0 6 0 0 0 0 0 19 11 11 12 0 9 0 6
6 0 19 11 11 12 0 3 0 0 0 0 0 0 0 6
6 0 0 0 0 0 0 6 0 0 0 0 0 0 0 6
19 11 11 11 11 11 11 11 11 11 11 11 11 11 11 21