0 1 1 1 1 1 1 1 1 1 1 1 1 1 1 2
3 4 11 4 4 4 4 4 4 4 4 11 4 4 4 5
3 4 24 19 20 4 21 19 19 19 19 25 19 23 4 5
3 4 14 4 4 4 14 4 4 4 4 14 4 14 4 5
3 4 14 4 21 19 26 4 21 20 4 14 4 17 4 5
3 4 14 4 17 4 14 4 14 4 4 17 4 4 4 5
3 4 14 4 4 4 17 4 14 4 9 4 4 11 4 5
3 4 14 4 18 20 4 4 14 4 4 4 4 14 4 5
3 4 14 4 4 4 4 4 24 19 19 20 4 17 4 5
3 4 27 19 19 20 4 11 4 4 4 4 4 4 4 5
3 4 4 4 4 4 4 17 4 4 4 4 4 4 4 5
6 7 7 7 7 7 7 7 7 7 7 7 7 7 7 8