0 1 1 1 1 1 1 1 1 1 1 1 1 1 1 2
10 10 16 10 10 10 10 10 10 10 10 16 10 10 10 16
13 10 26 21 22 10 23 21 21 21 21 27 21 25 10 16
16 10 16 10 10 10 16 10 10 10 10 16 10 16 10 16
16 10 16 10 23 21 28 10 23 22 10 16 10 19 10 16
16 10 16 10 19 10 16 10 16 10 10 19 10 10 10 16
16 10 16 10 10 10 19 10 16 10 11 10 10 13 10 16
16 10 16 10 20 22 10 10 16 10 10 10 10 16 10 16
16 10 16 10 10 10 10 10 29 21 21 22 10 19 10 16
16 10 29 21 21 22 10 13 10 10 10 10 10 10 10 16
16 10 10 10 10 10 10 16 10 10 10 10 10 10 10 16
29 21 21 21 21 21 21 21 21 21 21 21 21 21 21 31